1111111111111111111111111111
1011110111110110111110111101
1011111111101101111111110111
1011110111110110111110111101
1000000000C00000E00000000001
1000000000000000000P00000001
1111111111111111111111111111